1111111111111dddc
10010000000C1s
1000011111001s
1P0011E000001s
11111111111ffds
dd